****************
e         *    *
******* *** ** *
**    *     ** *
*  ** *** ***  *
* *       * * **
* ****** **    *
* ** *** *******
* *    **      *
* ** *    ** ***
* ** ***** * * *
* *    *       *
* ** ***** *****
*      ***     *
* *****    ** **
*************x**
